
Tuesday Block 3
Quinn Davignon => quartzDingo
Taigo Duarte => turquoiseDolphin
Steven Carvalho => salmonChameleon
Isabella Carrillo => indigoCat
Sam harria => salmonHartebeest
Stefan Hulsebosch => silverHamster

silverSolth ****** need H animal ******

Wednesday Block 3


Christian Noble Shriver => champagneNautilus
Quinn Palmer => quartzPanther
Tyler Trudeau => terraCottaTiger
Kayli Viera => keyLimeVicuna
Sean Lund => silverLion
KatelynLuong => keyLimeLlama
Cooper Newton => copperNewt
Spencer Perez Dormitzer => scarletPeruvianDonkey
Ethan Scully => emeraldSnake
Evan Smith => emeraldGreenSalamander
Bethany Morgan => blueManatee
Joseph Ziino => jasperZebra


Thursday Block 1
Will baltz => whiteBaboon
BrendanBurke => beigeBear
Isabel Fredrichs => indigoFox
Brody Garber => blueGreatWhiteShark
colby gross => cyanGorilla
Aiden Harrington => avocadoHorse

Friday Block 1
Colin Mackin => cyanMouse
Drew Mastovsky => danubeMonkey
Lukas Michaelis => lavenderMonkey
Savannah Teixiera => seaGreenTasmanianDevil
william tirrell => whiteTurtle
Will Lecuyer => whiteLizard


Honors Physics

Thursday Block 3

Owen bates => orangeBadger
Claudie Bellanger => coralBee
Elizabeth Bungert => evergreenBelugaWhale
Mia Costa => magentaCoral
Andrew Coucci => amberCamel
Katherine Dwyer => keyLimeDog
Abigail Forcier => aquaFlamingo
Rachel Foye => redFox
Maeve Geraghty => magentaGuineaPig
John Kassabian => jadeKoala
Raegan Rapoza => redRabbit


Friday Block 3

Elijah Motta => electricCrimsonMonkey
Lauryn Lent => lavenderLion
Samuel Noblet => sageNumbat
Faith Oliver => fernGreenOwl
Emilia Pinhancos => eggshellPenguin
Zach Proffitt => zenithBluePenguin
Tess Roznoy => tangerineRabbit
Stephen Sauerbrew => silverStingray
Emma Schwabe => emeraldGreenSnake
Kennedy Serpa => keppelSeaOtter
William Stark => whiteSalamander
Emma Vivino => evergreenVicuna
Rachel Zutaut => redZebra
Reily Veilleux => redVulture

Friday Block 2

Marc Pothier => magentaPanther
Charlie Richards => cadetBlueRobin
Hannah Teixeira => hazelTurkey
Kathleen Tenerowicz => keppelTiger
Jessica Vance => jadeVicuna
Sophie Vigeant => seaTealViper
Elizabeth (Bess) Wiggin => blueWhale
Emma Williamson => emeraldWolverine
Samantha Winters => siennaWallaby


Thursday Block 2

Amanda Armanetti => amethystAlpaca
Tristan Borges => titaniumWhiteBrachiosaurus
Emma Carroll => electricBlueChameleon
Evan Correia => emeraldCat
Mariana Ditata => magentaDog
Jenna Gamache => jadeGorilla
Isabella Hunter => indigoHedgehog
Jacob Jensen => japanRedJaguar
Brianna Machado => blueMonkey
Skylar Cardwell => salmonCapybara
Paige Zutaut => pumpkinZebu
Jake Cronin => jadeCaiman

Wednesday Block 1

Jill Langlais => jasperLynx
Keane MacGregor => keyLimeMoose
Rebecca Milde => redMoose
Drew Miranda => darkBlueMonkey
Serena O'Connell => sapphireOctopus
Bessire Pierre => bluePenguin
Apollo Prefontaine => amethystPython
Isabella Romig => blueRhino
Leah Scott => lavenderSheep
Teagan Shay => tealShark
Desmond Sinnott => darkBlue (deer) [need an S animal]
Brett Smith => blueSnail
Paige Sommers => pinkSnake
Gabrielle Theodore => greenTiger
Kinsley Trout => keyLimeTreeFrog

Tuesday Block 1

Stephen Arne => sapphireAnteater
Nathaniel Bangs => navyBlueLobster ****** (need an animal that begins with B)
Shelby Carmichael => sapphireChipmunk
Palmer Clingman => purpleCow
Hannah Davis => hazelDove
Emily Della Cioppa => emeraldDolphin
Reign Fernandes => roseFlamingo
Davis Fox => darkBlueFox
Bella Hedges => blueHippo
Faith Humphrey => fuchsiaHamster
Molly Janicki => magentaJaguar
Alex Wright => apricotWhale

Alex Wright (missing)
